00000000000000000000
22222222222222222220
22222222222222222220
22222222222222222220
22222222222222222220
11111111111111111110
00000000000000000000
02222222222222222222
02222222222222222222
02222222222222222222
02222222222222222222
01111111111111111111
00000000000000000000
