22222222222222222222
30000000044440000000
00011111011110101110
00111111000000101110
01111111111111100000
01111111111111111110
01000000000000000010
01111111111111111110
01111111111111111110
01111111000111111110
01111110000011111100
01111100111001111000
00000001444100000000
