00000000000000000000
11111111111111111110
11111111111111111110
11111111111111111110
11111111111111111110
11111111111111111110
00000000000000000000
01111111111111111111
01111111111111111111
01111111111111111111
01111111111111111100
01111111111111111000
00000000000000000000
