22222222222222222222
30000000000000000000
00014114114110110110
00011411411411411410
01141141141141141100
11011011011011011010
00000000000000000000
01111114111114111110
01111111411111411111
00000111141111141111
01110111114111114100
01110111111011111000
00000000000000000000
