00000000000000000000
10110110110110110110
11011011011011011010
01101101101101101100
10110110110110110110
11011011011011011010
00000000000000000000
01111110111110111110
01111111011111011111
00000111101111101111
01110111110111110111
01110111111011111011
00000000000000000000
