22222222222222222222
30000000000000000000
00010110110110110110
00011011011011011010
01101101101101101100
11011011011011011010
00000000000000000000
01111110111110111110
01111111011111011111
00000111101111101111
01110111110111110100
01110111111011111000
00000000000000000000
